____G__X
___XXX__
X______X
__XXXX__
___X____
__S__X__