____G__G
___XXX__
X______X
__XXXX_S
___X____
__S__X__